NO src/wall_pictures/diamond_ore.png
SO src/wall_pictures/lapis_ore.png
WE src/wall_pictures/redstone_ore.png
EA src/wall_pictures/coal_ore.png

C 0,184,205
F 0,40,20

		1111111111111111111111111
		1000000000000110000000001
		10110000011100000000000W1
		1001000000000000000000001
111111111011000001110000000000001
100000000011000001110111111111111
11110111111111011100000010001
11110111111111011101010010001
11000000110101011100000010001
10000000000000001100000010001
10000000000000001101010010001
1100000111010101111101111000111
11110111 1110101 101111010001
11111111 1111111 111111111111