NO ./wall_pictures/coal.png
SO ./wall_pictures/diamond_ore.png
WE ./wall_pictures/lapis_ore.png
EA ./wall_pictures/redstone_ore.png

C 0,184,205
F 30,15,15

1111111111
1000011111
1100000011
111N000001
1111111111
