NO ./wall_pictures/coal.png
SO ./wall_pictures/diamond_ore.png
WE ./wall_pictures/lapis_ore.png
EA ./wall_pictures/redstone_ore.png

C 0,184,205
F 30,15,15

11111
10P01
10001
10N00
10001
11111